1111111111111111111111111
1006000000000000000000001
1010161614101016101516101
1600006000600000606000001
1010131510141010101513101
1000006000600000606000001
1016141610101416101614101
1000000000000000000000001
1010131510101014101513101
1000006000600000606000061
1010161510101010101016101
1000000000000000000006001
1111111111111111111111111